111111111111
1PC0000000C1
100000001111
1000000010E1
111111111111